11111111111111111111111111111111111111111111111111111111
10C0000000000000000000000000000000C0000000000P000000C0E1
10000111111111111111111111111111111111111111111111100001
10100000000000000000000000CC0000000000000000000000000101
10001000111111111111111111111111111111111111111100010001
1000100000000000C00000C000000000000000000000000000010001
1010100100000000000000C000000000000000000000000010010101
10001001001111111111111110001111111111111111110010010001
10001001000000000000000000000000000000000000000010010001
10101001010011111111111111111111111111111110001010010101
1000100101000000000C0000000000C0000000000000001010010001
10001001010010011111111111111111111111100010001010010001
10101001010010000000000000000000000000000010001010010101
1000100101001010000C00000C000000000000010010001010010001
10001001010010100110011010101001100110010010001010010001
10101001010010100000000000000000000000010010001010010101
10001001010010000000000000000000000000000010001010010001
10001001010010011111111111111111111111100010001010010001
1010100101000000000000000000000000C00000000000101001C101
10001001010011111111111111111111111111111110001010010001
10001001000000000000000000000000000000000000000010010001
10101001001111111111111110001111111111111111110010010101
10001001000000000000000000000000000000000000000010010001
10001000000000000000000000000000000000000000000000010001
10101000111111111111111111111111111111111111111100010101
10000000000000000000000000000000000000000000000000000001
10000111111111111111111111111111111111111111111111100001
10000000000000000000000000000000000000000000000000000001
11111111111111111111111111111111111111111111111111111111